4	DIAMOND		3	0	0	3	6
4	DIAMOND		0	0	0	0	7
3	DIAMOND		0	3	3	5	3
5	DIAMOND		3	0	0	0	7
4	RUBY		0	0	7	0	0
4	RUBY		0	3	6	3	0
3	RUBY		3	5	3	0	3
5	RUBY		0	0	7	3	0
4	EMERALD		3	6	3	0	0
5	EMERALD		0	7	3	0	0
4	EMERALD 	0	7	0	0	0
3	EMERALD		5	0	3	3	3
4	SAPPHIRE	7	0	0	0	0
3	SAPPHIRE	3	0	3	3	5
5	SAPPHIRE	7	3	0	0	0
4	SAPPHIRE	6	3	0	0	3
5	ONYX		0	0	0	7	3
4	ONYX		0	0	0	7	0
4	ONYX		0	0	3	6	3
3	ONYX		3	3	5	3	0	