0	DIAMOND		0	2	0	0	2
0	DIAMOND		0	3	0	0	0
0	EMERALD		2	1	0	0	0
0	RUBY		3	0	0	0	0
0	RUBY		1	1	1	0	1
0	SAPPHIRE	1	0	1	2	1
0	ONYX		0	0	2	1	0
0	SAPPHIRE	1	0	2	2	0
0	ONYX		1	1	1	1	0
0	DIAMOND		0	2	2	0	1
0	RUBY		2	0	1	0	2
0	ONYX		2	0	2	0	0
0	RUBY		0	2	1	0	0
0	EMERALD		0	1	0	2	2
0	DIAMOND		0	1	2	1	1
0	EMERALD		1	3	1	0	0
0	SAPPHIRE	1	0	1	1	1
0	RUBY		2	0	0	2	0
0	ONYX		2	2	0	1	0
0	EMERALD		1	1	0	1	2
0	EMERALD		1	1	0	1	1
1	ONYX		0	4	0	0	0
0	EMERALD		0	0	0	3	0
1	DIAMOND		0	0	4	0	0
0	DIAMOND		3	1	0	0	1
1	SAPPHIRE	0	0	0	4	0
0	DIAMOND		0	0	0	2	1
1	EMERALD		0	0	0	0	4
0	DIAMOND		0	1	1	1	1
0	RUBY		2	1	1	0	1
0	SAPPHIRE	0	0	0	0	3
0	ONYX		0	0	3	0	0
0	SAPPHIRE	0	1	3	1	0
0	EMERALD		0	2	0	0	2
0	ONYX		0	0	1	3	1
0	SAPPHIRE	0	0	2	0	2
1	RUBY		4	0	0	0	0
0	ONYX		1	2	1	1	0
0	SAPPHIRE	1	0	0	0	2
0	RUBY		1	0	0	1	3
