3	DIAMOND		6	0	0	0	0
3	ONYX		0	0	0	0	6
1	ONYX		3	0	3	0	2
1	ONYX		3	2	2	0	0
1	SAPPHIRE	0	2	3	0	3
2	SAPPHIRE	2	0	0	1	4
2	EMERALD		0	0	5	0	0
1	DIAMOND		0	0	3	2	2
2	DIAMOND		0	0	0	5	3
2	DIAMOND		0	0	0	5	0
2	SAPPHIRE	5	3	0	0	0
1	RUBY		0	3	0	2	3
2	DIAMOND		0	0	1	4	2
1	EMERALD		2	3	0	0	2
1	DIAMOND		2	3	0	3	0
1	RUBY		2	0	0	2	3
3	EMERALD		0	0	6	0	0
2	ONYX		0	1	4	2	0
2	RUBY		1	4	2	0	0
2	SAPPHIRE	0	5	0	0	0
2	ONYX		0	0	5	3	0
3	RUBY		0	0	0	6	0
1	EMERALD		3	0	2	3	0
3	SAPPHIRE	0	6	0	0	0
1	SAPPHIRE	0	2	2	3	0
2	EMERALD		4	2	0	0	1
2	RUBY		3	0	0	0	5
2	ONYX		5	0	0	0	0
2	RUBY		0	0	0	0	5
2	EMERALD		0	5	3	0	0
